NO      ./textures/N64.xpm
SO    ./textures/S64.xpm
WE ./textures/W64.xpm
EA              ./textures/E64.xpm

F 220,100,0
C 255,255,255

11111111111111111111111111
10000000000000000000100001
10000000000000000000100001
1000000000000000E000100001
1000000000000000000010000 
10000000010000000000000001
10000000000000000000000001
10000000000000000000000001
11111111111111111111111111
