NO      ./textures/Box256.xpm
SO    ./textures/Door256.xpm
WE ./textures/Wall256.xpm
EA              ./textures/Volet256.xpm

F 125,125,255
C                 255,87,255

        1111111111111111111111111
        1000000000110000000000001
        10110000011100000T0000001
        100100000000000000000T011
111111111011000001110000000000E01
100000000011000001110111110111111
11110111111111011100000010001
11110111111111011101010010001
11000000110101011100000010001
10000000000000001100000010001
10000T00000000001101010010001
11000001110101T1111101111000111
11110111 1110101 101111010001
11111111 1111111 111111111111
